111111111111111111
1P0000000C00010C01
1000Y000100Y011101
100111111000C001C1
100100000011100001
11110C000000100001
10C111110000110001
10010C0100Z0010001
10000Y000000010E01
111111111111111111
