1111111111111111111
1P0000Y00C00010C001
11111000100Y0111001
100001111000C001C01
1001000Z00111000001
11110C0000001000001
10C1111100011111001
10010C0110Z00100Y01
10000Y000000010E001
1111111111111111111
